80 25
000000000000000000RRR000000000000000000000000000000000RRR00000000000000000000000
00000000000G000000RRR000000000000000000000000000000000RRR00000G00000000000000000
00000000000GG00000RRR000000000000000000000000000000000RRR0000GG00000000000000000
00000000000GGG0000RRR000000000000000000000000000000000RRR000GGG00000000000000000
00000000000GGG0000RRR000RRRRRRRRRRRRRRRRRRRRRRRRRRR000RRR000GGG00000000000000000
00000000000GGGG000RRR0RR000000000000000000000000000RR0RRR00GGGG00000000000000000
00000000000GGGGG00RRRR00000WW000000000000000WW0000000RRRR00GGGGG0000000000000000
00000000000GGGGGGGRRRR000W0000W00000000000W0000W00000RRRRGGGGGGG0000000000000000
00000000000GGGGGGGRRRR000W0YY0W00000000000W0YY0W00000RRRRGGGGGGG0000000000000000
00000000000GGGGGGGRRRR000W0000W00000000000W0000W00000RRRRGGGGGGG0000000000000000
00000000000GGGGGGGRRRR00000WW0000000C0000000WW0000000RRRRGGGGGGG0000000000000000
00000000000GGGGGGG00RRR00000000000CCCCC0000000000000RRR00GGGGGGG0000000000000000
0000000000000000R00000R00000000000CCCCC0000000000000R00000R000000000000000000000
00000000000000000R00000R000000000000000000000000000R00000R0000000000000000000000
000000000000000000R0000YR0000000000000000000000000RY0000R00000000000000000000000     0000000000000000000R000Y0R00000000000000000000000R0Y000R000000000000000000000000
00000000000000000000R0000YR000000000000000000000RY0000R0000000000000000000000000
000000000000000000000R000Y0RRRRRRRRRRRRRRRRRRRRR0Y000R00000000000000000000000000
0000000000000000000000R00000Y000Y000Y000Y000Y000Y000R000000000000000000000000000
00000000000000000000000R0000Y0Y0Y0Y0Y0Y0Y0Y0Y0Y0Y00R0000000000000000000000000000
000000000000000000000000R00000Y000Y000Y000Y000Y000R00000000000000000000000000000
0000000000000000000000000RRRRRRRRRRRRRRRRRRRRRRRRR000000000000000000000000000000
00000000000000000000000000000000000000000000000000000000000000000000000000000000
00000000000000000000000000000000000000000000000000000000000000000000000000000000
00000000000000000000000000000000000000000000000000000000000000000000000000000000