80 25 
################################################################################
################################################################################
000000000000000000000000000000000000000000000000000000000000000000000000000000##
000000000000000000000000000000000000000000000000000000000000000000000000000000##
000000000000000000000000000000000000000000000000000000000000000000000000000000##
00000#0#0#0#0#0#0#0#0#0#0#0#0#0#0#0#0#0#0#0#0#0#0#0#0#0#0#0#0#0#0#0#0#00000000##
000000#0#0#0#0#0#0#0#0#0#0#0#0#0#0#0#0#0#0#0#0#0#0#0#0#0#0#0#0#0#0#0#000000000##
000000000000000000000000000000000000000000000000000000000000000000000000000000##
00000#0#0#0#0#0#0#0#0#0#0#0#0#0#0#0#0#0#0#0#0#0#0#0#0#0#0#0#0#0#0#0#0#00000000##
000000#0#0#0#0#0#0#0#0#0#0#0#0#0#0#0#0#0#0#0#0#0#0#0#0#0#0#0#0#0#0#0#000000000##
000000000000000000000000000000000000000000000000000000000000000000000000000000##
00000#0#0#0#0#0#0#0#0#0#0#0#0#0#0#0#0#0#0#0#0#0#0#0#0#0#0#0#0#0#0#0#0#00000000##
000000#0#0#0#0#0#0#0#0#0#0#0#0#0#0#0#0#0#0#0#0#0#0#0#0#0#0#0#0#0#0#0#000000000##
000000000000000000000000000000000000000000000000000000000000000000000000000000##
00000#0#0#0#0#0#0#0#0#0#0#0#0#0#0#0#0#0#0#0#0#0#0#0#0#0#0#0#0#0#0#0#0#00000000##
000000#0#0#0#0#0#0#0#0#0#0#0#0#0#0#0#0#0#0#0#0#0#0#0#0#0#0#0#0#0#0#0#000000000##
000000000000000000000000000000000000000000000000000000000000000000000000000000##
00000#0#0#0#0#0#0#0#0#0#0#0#0#0#0#0#0#0#0#0#0#0#0#0#0#0#0#0#0#0#0#0#0#00000000##
000000#0#0#0#0#0#0#0#0#0#0#0#0#0#0#0#0#0#0#0#0#0#0#0#0#0#0#0#0#0#0#0#000000000##
000000000000000000000000000000000000000000000000000000000000000000000000000000##
00000#0#0#0#0#0#0#0#0#0#0#0#0#0#0#0#0#0#0#0#0#0#0#0#0#0#0#0#0#0#0#0#0#00000000##
000000#0#0#0#0#0#0#0#0#0#0#0#0#0#0#0#0#0#0#0#0#0#0#0#0#0#0#0#0#0#0#0#000000000##
000000000000000000000000000000000000000000000000000000000000000000000000000000##
000000000000000000000000000000000000000000000000000000000000000000000000000000##
000000000000000000000000000000000000000000000000000000000000000000000000000000##
