80 25 
%#000000000000000000000000000000000000000000000000000000000000000000000000000000
%#000000000000000000000000000000000000000000000000000000000000000000000000000000
%#000000000000000000000000000000000000000000000000000000000000000000000000000000
%#000000000000000000000#####################################00000000000000000000
%#000000000000000000000#00000000000000000000000000000000000#00000000000000000000
%#000000000000000000000#0################################00#00000000000000000000
%#000000000000000000000#0#000000000000000000000000000000#00#00000000000000000000
%#000000000000000000000#0#0############################0#00#00000000000000000000
%#000000000000000000000#0#0#00000000000000000000000000#0#00#00000000000000000000
%#000000000000000000000#0#0#00000000000000000000000000#0#00#00000000000000000000
%#000000000000000000000000000000000000000000000000000000000000000000000000000000
%#000000000000000000000000000000000000000000000000000000000000000000000000000000
%#000000000000000000000000000000000000000000000000000000000000000000000000000000
%#000000000000000000000000000000000000000000000000000000000000000000000000000000
%#000000000000000000000000000000000000000000000000000000000000000000000000000000
%#000000000000000000000#0#0#00000000000000000000000000#0#00#00000000000000000000
%#000000000000000000000#0#0#00000000000000000000000000#0#00#00000000000000000000
%#000000000000000000000#0#0############################0#00#00000000000000000000
%#000000000000000000000#0#000000000000000000000000000000#00#00000000000000000000
%#000000000000000000000#0################################00#00000000000000000000
%#000000000000000000000#00000000000000000000000000000000000#00000000000000000000
%#000000000000000000000#####################################00000000000000000000
%#000000000000000000000000000000000000000000000000000000000000000000000000000000
%###############################################################################
%%%%%%%%%%%%%%%%%%%%%%%%%%%%%%%%%%%%%%%%%%%%%%%%%%%%%%%%%%%%%%%%%%%%%%%%%%%%%%%%