80 25 
%%%%%%%%%%%%%%%%%%%%%%%%%%%%%%%%%%%%%%%%%%%%%%%%%%%%%%%%%%%%%%%%%%%%%%%%%%%%%%%%
%###############################################################################
%#000000000000000000000000000000000000000000000000000000000000000000000000000000
%#000000000000000000000000000000000000000000000000000000000000000000000000000000
%#000000000000000000000000000000000000000000000000000000000000000000000000000000
%#000000000000000000000000000000000000000000000000000000000000000000000000000000
%#000000000000000000000000000000000000000000000000000000000000000000000000000000
%#000000000000000000000000000000000000000000000000000000000000000000000000000000
%#000000000000000000000000000000000000000000000000000000000000000000000000000000
%#000000000000000000000000000000000000000000000000000000000000000000000000000000
%#000000000000000000000000000000000000000000000000000000000000000000000000000000
%#000000000000000000000000000000000000000000000000000000000000000000000000000000
%#000000000000000000000000000000000000000000000000000000000000000000000000000000
%#000000000000000000000000000000000000000000000000000000000000000000000000000000
%#000000000000000000000000000000000000000000000000000000000000000000000000000000
%#000000000000000000000000000000000000000000000000000000000000000000000000000000
%#000000000000000000000000000000000000000000000000000000000000000000000000000000
%#000000000000000000000000000000000000000000000000000000000000000000000000000000
%#000000000000000000000000000000000000000000000000000000000000000000000000000000
%#000000000000000000000000000000000000000000000000000000000000000000000000000000
%#000000000000000000000000000000000000000000000000000000000000000000000000000000
%#000000000000000000000000000000000000000000000000000000000000000000000000000000
%#000000000000000000000000000000000000000000000000000000000000000000000000000000
%#000000000000000000000000000000000000000000000000000000000000000000000000000000
%#000000000000000000000000000000000000000000000000000000000000000000000000000000
